111111111111111111
1P0100000000000001
101111100000010101
101100001100011001
101001111110100101
10C00C101111100001
100001000C010C0001
1000110100000001E1
111111111111111111