11111111111111111111111111111111111111111111111111111111111111
1C0111C100C00000000C0000000C0000000011100C110C10000110000000E1
10000011011111111111111111111000001111110111101C01111100000011
11110011011001100000000000001111111101110001001001001111111111
1C000000C10011110010111C0000P001100011100000001000000100010001
11110111110110110110001111000011000001011111011111111110011001
100C000C010011001000000000110110001001C1C1C1C110000C0111111101
1C00110001C010000011100011100010010101C1C1C1C100C00000011000C1
11011100C11011C011100010000C0C00101010C1C1C1000011111111111111
1001101011001010001111000111111011100C1011111111C00100010000C1
1000100000000000001111000100000001C00CC1011100C1C0111001100001
11101111111001100C010C00100011110000001C00000001C11111C1111111
1C00000101101CC1000000000001100111111101111110001C000C1C011001
100000101001000111111111111C00C1110C00111100000001111111111001
11101110101001010101000000C10000101101001100C11100000001111001
1CCCCCC010000000001011111000111111001111010C1111111111101111C1
100000000000010100010000000C00000000C00000C111C0000000000100C1
11111111111111111111111111111111111111111111111111111111111111